Account,Value,Balance on this account,Total balance
Checking,5,5,5
Savings,3,3,8
Savings,7,10,15
Checking,-4,1,11
Checking,10,11,21
Savings,5,15,26
Checking,-5,6,21
